.; ;.; ;.; ;.; ;.; ;.; ;.; ;.; ;.; ;.; ;.; ;.; ;.; ;.; ;.; ;.; ;.; ;.; ;.; ;.; ;.; ;.; ;.; ;.; ;.; ;.; ;.; ;.; 
 ; ; ; ; ; ; ; ; ; ; ; ; ; ; ; ; ; ; ; ; ; ; ; ; ; ; ; ; ; ; ; ; ; ; ; ; ; ; ; ; ; ; ; ; ; ; ; ; ; ; ; ; ; ; ; 
.; ;.; ;.; ;.; ;.; ;.; ;.; ;.; ;.; ;.; ;.; ;.; ;.; ;.; ;.; ;.; ;.; ;.; ;.; ;.; ;.; ;.; ;.; ;.; ;.; ;.; ;.; ;.; 
 ; ; ; ; ; ; ; ; ; ; ; ; ; ; ; ; ; ; ; ; ; ; ; ; ; ; ; ; ; ; ; ; ; ; ; ; ; ; ; ; ; ; ; ; ; ; ; ; ; ; ; ; ; ; ; 
.; ;.; ;.; ;.; ;.; ;.; ;.; ;.; ;.; ;.; ;.; ;.; ;.; ;.; ;.; ;.; ;.; ;.; ;.; ;.; ;.; ;.; ;.; ;.; ;.; ;.; ;.; ;.; 
 ; ; ; ; ; ; ; ; ; ; ; ; ; ; ; ; ; ; ; ; ; ; ; ; ; ; ; ; ; ; ; ; ; ; ; ; ; ; ; ; ; ; ; ; ; ; ; ; ; ; ; ; ; ; ; 
.; ;.; ;.; ;.; ;.; ;.; ;.; ;.; ;.; ;.; ;.; ;.; ;.; ;.; ;.; ;.; ;.; ;.; ;.; ;.; ;.; ;.; ;.; ;.; ;.; ;.; ;.; ;.; 
 ; ; ; ; ; ; ; ; ; ; ; ; ; ; ; ; ; ; ; ; ; ; ; ; ; ; ; ; ; ; ; ; ; ; ; ; ; ; ; ; ; ; ; ; ; ; ; ; ; ; ; ; ; ; ; 
.; ;.; ;.; ;.; ;.; ;.; ;.; ;.; ;.; ;.; ;.; ;.; ;.; ;.; ;.; ;.; ;.; ;.; ;.; ;.; ;.; ;.; ;.; ;.; ;.; ;.; ;.; ;.; 
 ; ; ; ; ; ; ; ; ; ; ; ; ; ; ; ; ; ; ; ; ; ; ; ; ; ; ; ; ; ; ; ; ; ; ; ; ; ; ; ; ; ; ; ; ; ; ; ; ; ; ; ; ; ; ; 
.; ;.; ;.; ;.; ;.; ;.; ;.; ;.; ;.; ;.; ;.; ;.; ;.; ;.; ;.; ;.; ;.; ;.; ;.; ;.; ;.; ;.; ;.; ;.; ;.; ;.; ;.; ;.; 
 ; ; ; ; ; ; ; ; ; ; ; ; ; ; ; ; ; ; ; ; ; ; ; ; ; ; ; ; ; ; ; ; ; ; ; ; ; ; ; ; ; ; ; ; ; ; ; ; ; ; ; ; ; ; ; 
.; ;.; ;.; ;P; ;.; ;.; ;.; ;.; ;.; ;.; ;.; ;.; ;.; ;.; ;.; ;.; ;.; ;.; ;.; ;.; ;.; ;.; ;.; ;.; ;.; ;.; ;.; ;.; 
 ; ; ; ; ; ; ; ; ; ; ; ; ; ; ; ; ; ; ; ; ; ; ; ; ; ; ; ; ; ; ; ; ; ; ; ; ; ; ; ; ; ; ; ; ; ; ; ; ; ; ; ; ; ; ; 
.; ;.; ;.; ;.; ;.; ;.; ;.; ;.; ;.; ;.; ;.; ;.; ;.; ;.; ;.; ;.; ;.; ;.; ;.; ;.; ;.; ;.; ;.; ;.; ;.; ;.; ;.; ;.; 
 ; ; ; ; ; ; ; ; ; ; ; ; ; ; ; ; ; ; ; ; ; ; ; ; ; ; ; ; ; ; ; ; ; ; ; ; ; ; ; ; ; ; ; ; ; ; ; ; ; ; ; ; ; ; ; 
.; ;.; ;.; ;.; ;.; ;.; ;.; ;.; ;.; ;.; ;.; ;i; ;.; ;.; ;.; ;.; ;.; ;.; ;.; ;.; ;.; ;.; ;o; ;.; ;.; ;.; ;.; ;.; 
 ; ; ; ; ; ; ; ; ; ; ; ; ; ; ; ; ; ; ; ; ; ; ; ; ; ; ; ; ; ; ; ; ; ; ; ; ; ; ; ; ; ; ; ; ; ; ; ; ; ; ; ; ; ; ; 
.; ;.; ;.; ;.; ;.; ;.; ;.; ;.; ;.; ;.; ;.; ;.; ;.; ;.; ;.; ;p; ;.; ;c; ;.; ;.; ;.; ;.; ;.; ;.; ;.; ;.; ;.; ;.; 
 ; ; ; ; ; ; ; ; ; ; ; ; ; ; ; ; ; ; ; ; ; ; ; ; ; ; ; ; ; ; ; ; ; ; ; ; ; ; ; ; ; ; ; ; ; ; ; ; ; ; ; ; ; ; ; 
.; ;.; ;.; ;.; ;.; ;.; ;.; ;.; ;.; ;.; ;.; ;.; ;.; ;.; ;.; ;.; ;.; ;.; ;.; ;.; ;.; ;.; ;.; ;.; ;.; ;.; ;.; ;.; 
 ; ; ; ; ; ; ; ; ; ; ; ; ; ; ; ; ; ; ; ; ; ; ; ; ; ; ; ; ; ; ; ; ; ; ; ; ; ; ; ; ; ; ; ; ; ; ; ; ; ; ; ; ; ; ; 
.; ;.; ;.; ;.; ;.; ;.; ;.; ;.; ;.; ;.; ;.; ;.; ;.; ;.; ;.; ;.; ;.; ;.; ;.; ;.; ;.; ;.; ;.; ;.; ;.; ;.; ;.; ;.; 
 ; ; ; ; ; ; ; ; ; ; ; ; ; ; ; ; ; ; ; ; ; ; ; ; ; ; ; ; ; ; ; ; ; ; ; ; ; ; ; ; ; ; ; ; ; ; ; ; ; ; ; ; ; ; ; 
.; ;.; ;.; ;.; ;.; ;.; ;.; ;.; ;.; ;.; ;b; ;.; ;.; ;.; ;.; ;.; ;.; ;.; ;.; ;.; ;.; ;o; ;.; ;.; ;.; ;.; ;.; ;.; 
 ; ; ; ; ; ; ; ; ; ; ; ; ; ; ; ; ; ; ; ; ; ; ; ; ; ; ; ; ; ; ; ; ; ; ; ; ; ; ; ; ; ; ; ; ; ; ; ; ; ; ; ; ; ; ; 
.; ;.; ;.; ;.; ;.; ;.; ;.; ;.; ;.; ;.; ;.; ;.; ;.; ;.; ;.; ;.; ;.; ;.; ;.; ;.; ;.; ;.; ;.; ;.; ;.; ;.; ;.; ;.; 
 ; ; ; ; ; ; ; ; ; ; ; ; ; ; ; ; ; ; ; ; ; ; ; ; ; ; ; ; ; ; ; ; ; ; ; ; ; ; ; ; ; ; ; ; ; ; ; ; ; ; ; ; ; ; ; 
.; ;.; ;.; ;.; ;.; ;.; ;.; ;.; ;.; ;.; ;.; ;.; ;.; ;.; ;.; ;.; ;.; ;.; ;.; ;.; ;.; ;.; ;.; ;.; ;.; ;.; ;.; ;.; 
 ; ; ; ; ; ; ; ; ; ; ; ; ; ; ; ; ; ; ; ; ; ; ; ; ; ; ; ; ; ; ; ; ; ; ; ; ; ; ; ; ; ; ; ; ; ; ; ; ; ; ; ; ; ; ; 
.; ;.; ;.; ;.; ;.; ;.; ;.; ;.; ;.; ;.; ;.; ;.; ;.; ;.; ;.; ;.; ;.; ;.; ;.; ;.; ;.; ;.; ;.; ;.; ;.; ;.; ;.; ;.; 
 ; ; ; ; ; ; ; ; ; ; ; ; ; ; ; ; ; ; ; ; ; ; ; ; ; ; ; ; ; ; ; ; ; ; ; ; ; ; ; ; ; ; ; ; ; ; ; ; ; ; ; ; ; ; ; 
.; ;.; ;.; ;.; ;.; ;.; ;.; ;.; ;.; ;.; ;.; ;.; ;.; ;.; ;.; ;.; ;.; ;.; ;x;x;.; ;.; ;.; ;.; ;.; ;.; ;.; ;.; ;.; 
 ; ; ; ; ; ; ; ; ; ; ; ; ; ; ; ; ; ; ; ; ; ; ; ; ; ; ; ; ; ; ; ; ; ; ; ;x;x; ; ; ; ; ; ; ; ; ; ; ; ; ; ; ; ; ; 
.; ;.; ;.; ;.; ;.; ;.; ;.; ;.; ;.; ;.; ;.; ;.; ;.; ;.; ;.; ;.; ;.; ;.; ;.; ;.; ;.; ;.; ;.; ;.; ;.; ;.; ;.; ;.; 
 ; ; ; ; ; ; ; ; ; ; ; ; ; ; ; ; ; ; ; ; ; ; ; ; ; ; ; ; ; ; ; ; ; ; ; ; ; ; ; ; ; ; ; ; ; ; ; ; ; ; ; ; ; ; ; 
.; ;.; ;.; ;.; ;.; ;.; ;.; ;.; ;.; ;.; ;.; ;.; ;.; ;.; ;.; ;.; ;x;x;.; ;.; ;.; ;.; ;.; ;.; ;.; ;.; ;.; ;.; ;.; 
 ; ; ; ; ; ; ; ; ; ; ; ; ; ; ; ; ; ; ; ; ; ; ; ; ; ; ; ; ; ; ; ;x;x; ; ; ; ; ; ; ; ; ; ; ; ; ; ; ; ; ; ; ; ; ; 
.; ;.; ;.; ;.; ;.; ;.; ;.; ;.; ;.; ;.; ;.; ;.; ;.; ;.; ;.; ;.; ;.; ;.; ;.; ;.; ;.; ;.; ;.; ;.; ;.; ;.; ;.; ;.; 
 ; ; ; ; ; ; ; ; ; ; ; ; ; ; ; ; ; ; ; ; ; ; ; ; ; ; ; ; ; ; ; ; ; ; ; ; ; ; ; ; ; ; ; ; ; ; ; ; ; ; ; ; ; ; ; 
.; ;.; ;.; ;.; ;.; ;.; ;.; ;.; ;.; ;.; ;.; ;.; ;.; ;.; ;.; ;.; ;.; ;.; ;.; ;.; ;.; ;o; ;.; ;.; ;.; ;.; ;.; ;.; 
 ; ; ; ; ; ; ; ; ; ; ; ; ; ; ; ; ; ; ; ; ; ; ; ; ; ; ; ; ; ; ; ; ; ; ; ; ; ; ; ; ; ; ; ; ; ; ; ; ; ; ; ; ; ; ; 
.; ;.; ;.; ;.; ;.; ;.; ;.; ;.; ;.; ;.; ;.; ;.; ;.; ;.; ;.; ;.; ;.; ;.; ;.; ;x;x;.; ;.; ;.; ;.; ;.; ;.; ;.; ;.; 
 ; ; ; ; ; ; ; ; ; ; ; ; ; ; ; ; ; ; ; ; ; ; ; ; ; ; ; ; ; ; ; ; ; ; ; ; ; ;x;x; ; ; ; ; ; ; ; ; ; ; ; ; ; ; ; 
.; ;.; ;.; ;.; ;.; ;.; ;.; ;.; ;.; ;.; ;.; ;.; ;.; ;.; ;.; ;.; ;.; ;.; ;.; ;.; ;.; ;.; ;x;x;.; ;.; ;.; ;.; ;.; 
 ; ; ; ; ; ; ; ; ; ; ; ; ; ; ; ; ; ; ; ; ; ; ; ; ; ; ; ; ; ; ; ; ; ; ; ; ; ; ; ; ; ; ; ;x;x; ; ; ; ; ; ; ; ; ; 
.; ;.; ;.; ;.; ;.; ;.; ;.; ;.; ;.; ;.; ;.; ;.; ;.; ;.; ;.; ;.; ;.; ;.; ;.; ;.; ;.; ;.; ;.; ;.; ;.; ;.; ;.; ;.; 
 ; ; ; ; ; ; ; ; ; ; ; ; ; ; ; ; ; ; ; ; ; ; ; ; ; ; ; ; ; ; ; ; ; ; ; ; ; ; ; ; ; ; ; ; ; ; ; ; ; ; ; ; ; ; ; 
.; ;.; ;.; ;.; ;.; ;.; ;.; ;.; ;.; ;.; ;.; ;.; ;.; ;.; ;.; ;.; ;.; ;.; ;.; ;.; ;x;x;.; ;.; ;.; ;.; ;.; ;.; ;.; 
 ; ; ; ; ; ; ; ; ; ; ; ; ; ; ; ; ; ; ; ; ; ; ; ; ; ; ; ; ; ; ; ; ; ; ; ; ; ; ; ;x;x; ; ; ; ; ; ; ; ; ; ; ; ; ; 
.; ;.; ;.; ;.; ;.; ;.; ;.; ;.; ;.; ;.; ;.; ;.; ;.; ;.; ;.; ;.; ;.; ;.; ;.; ;.; ;.; ;.; ;.; ;.; ;.; ;.; ;.; ;.; 
 ; ; ; ; ; ; ; ; ; ; ; ; ; ; ; ; ; ; ; ; ; ; ; ; ; ; ; ; ; ; ; ; ; ; ; ; ; ; ; ; ; ; ; ; ; ; ; ; ; ; ; ; ; ; ; 
.; ;.; ;.; ;.; ;.; ;.; ;.; ;.; ;.; ;.; ;x;x;.; ;.; ;.; ;.; ;.; ;.; ;.; ;.; ;.; ;.; ;.; ;.; ;.; ;.; ;.; ;.; ;.; 
 ; ; ; ; ; ; ; ; ; ; ; ; ; ; ; ; ; ; ; ;x;x; ; ; ; ; ; ; ; ; ; ; ; ; ; ; ; ; ; ; ; ; ; ; ; ; ; ; ; ; ; ; ; ; ; 
.; ;.; ;.; ;.; ;.; ;.; ;.; ;.; ;.; ;.; ;.; ;.; ;.; ;.; ;.; ;.; ;.; ;.; ;.; ;.; ;.; ;.; ;.; ;.; ;.; ;.; ;.; ;.; 
 ; ; ; ; ; ; ; ; ; ; ; ; ; ; ; ; ; ; ; ; ; ; ; ; ; ; ; ; ; ; ; ; ; ; ; ; ; ; ; ; ; ; ; ; ; ; ; ; ; ; ; ; ; ; ; 
.; ;.; ;.; ;.; ;.; ;.; ;.; ;.; ;.; ;.; ;.; ;.; ;.; ;.; ;.; ;.; ;.; ;.; ;.; ;.; ;.; ;.; ;.; ;.; ;.; ;.; ;.; ;.; 
 ; ; ; ; ; ; ; ; ; ; ; ; ; ; ; ; ; ; ; ; ; ; ; ; ; ; ; ; ; ; ; ; ; ; ; ; ; ; ; ; ; ; ; ; ; ; ; ; ; ; ; ; ; ; ; 
.; ;.; ;.; ;.; ;.; ;.; ;.; ;.; ;.; ;.; ;.; ;.; ;.; ;.; ;.; ;.; ;.; ;.; ;.; ;.; ;.; ;.; ;.; ;.; ;.; ;.; ;.; ;.; 
 ; ; ; ; ; ; ; ; ; ; ; ; ; ; ; ; ; ; ; ; ; ; ; ; ; ; ; ; ; ; ; ; ; ; ; ; ; ; ; ; ; ; ; ; ; ; ; ; ; ; ; ; ; ; ; 
.; ;.; ;.; ;.; ;.; ;.; ;.; ;.; ;.; ;.; ;.; ;.; ;.; ;.; ;.; ;.; ;.; ;.; ;.; ;.; ;.; ;.; ;.; ;.; ;.; ;.; ;.; ;.; 
 ; ; ; ; ; ; ; ; ; ; ; ; ; ; ; ; ; ; ; ; ; ; ; ; ; ; ; ; ; ; ; ; ; ; ; ; ; ; ; ; ; ; ; ; ; ; ; ; ; ; ; ; ; ; ; 